linea numerica empieza en:,termina en:,nro de operaciones,lista de operaciones,representacion,x
1,10,1,,-1,0
1,10,9,2 3 4 5 6 10 9 8 7,0,0
1,10,19,1 3 5 7 9 1 4 7 10 2 4 2 6 4 9 7 5 3 1,1,0
1,10,14,2 3 2 4 2 5 2 6 2 7 2 8 2 9,2,0
1,10,14,2 4 6 8 10 12 3 10 6 10 9 10 12 10,3,0
1,10,16,5 7 5 8 5 10 10 8 4 9 4 9 10 9 8 7,4,0
1,13,16,5 10 15 5 7 9 11 13 10 7 4 1 13 8 3 8,5,0