representacion;linea numerica empieza en:;termina en:;nro de operaciones;lista de operaciones
1;0;10;5;1 3 5 7 9
1;0;10;4;1 4 7 10
1;0;10;5;2 4 2 6 4
1;0;10;5;9 7 5 3 1
2;0;13;4;2 3 2 4
2;0;13;4;2 5 2 6
2;5;13;6;2 7 2 8 2 9
3;5;13;3;2 4 6
3;5;13;3;8 10 12
3;5;13;4;3 10 6 10
3;5;13;4;9 10 12 10
5;5;18;16; 5 10 15 5 7 9 11 13 10 7 4 1 13 8 3 8